1111111111	2
2222222222	1
4444444444	4
3333333333	6
6666666666	5
9999999999	3
8888888888	9
7777777777	8
5555555555	7
6666666666	0
6666666666	4
2222222222	3
aaaaaaaaaa	5
cccccccccc	6
gggggggggg	2
bbbbbbbbbb	3
dddddddddd	4