01 111	01 222	01 333	01 444	01 555	01 666	01 777	01 888	01 999
02 111	02 222	02 333	02 444	02 555	02 666	02 777	02 888	02 999
03 111	03 222	03 333	03 444	03 555	03 666	03 777	03 888	03 999
04 111	04 222	04 333	04 444	04 555	04 666	04 777	04 888	04 999
05 111	05 222	05 333	05 444	05 555	05 666	05 777	05 888	05 999
01 111;01 222;01 333;01 444;01 555;01 666;01 777;01 888;01 999
02 111;02 222;02 333;02 444;02 555;02 666;02 777;02 888;02 999
03 111;03 222;03 333;03 444;03 555;03 666;03 777;03 888;03 999
04 111;04 222;04 333;04 444;04 555;04 666;04 777;04 888;04 999
05 111;05 222;05 333;05 444;05 555;05 666;05 777;05 888;05 999